//MAP CONVERTED BY dmm2tgm.py THIS HEADER COMMENT PREVENTS RECONVERSION, DO NOT REMOVE
"ao" = (
/obj/structure/sign/flag/mothic,
/turf/closed/wall/mineral/titanium/survival/nodiagonal,
/area/shuttle/pirate)
"aA" = (
/obj/machinery/door/airlock/engineering,
/obj/machinery/atmospherics/pipe/smart/manifold4w/supply/hidden{
	dir = 4
	},
/obj/structure/cable,
/obj/effect/mapping_helpers/airlock/cutaiwire,
/turf/open/floor/plating/airless,
/area/shuttle/pirate)
"aW" = (
/obj/machinery/suit_storage_unit/pirate{
	helmet_type = /obj/item/clothing/head/helmet/space/pirate/tophat;
	suit_type = /obj/item/clothing/suit/space/pirate/silverscale
	},
/obj/effect/turf_decal/bot_red,
/turf/open/floor/iron/smooth,
/area/shuttle/pirate)
"cB" = (
/obj/structure/lattice/catwalk,
/obj/structure/railing{
	dir = 4
	},
/turf/template_noop,
/area/shuttle/pirate)
"cO" = (
/obj/structure/lattice/catwalk,
/obj/structure/railing{
	dir = 9
	},
/turf/template_noop,
/area/shuttle/pirate)
"cS" = (
/obj/structure/lattice/catwalk,
/obj/structure/railing,
/turf/template_noop,
/area/shuttle/pirate)
"cU" = (
/obj/structure/lattice/catwalk,
/obj/structure/railing{
	dir = 6
	},
/turf/template_noop,
/area/shuttle/pirate)
"dh" = (
/obj/item/spear/military,
/obj/structure/rack,
/obj/item/claymore/shortsword{
	pixel_y = -5
	},
/turf/open/floor/pod/light,
/area/shuttle/pirate)
"dp" = (
/obj/machinery/airalarm/directional/south,
/obj/effect/mapping_helpers/airalarm/all_access,
/turf/open/floor/plating/airless,
/area/shuttle/pirate)
"dq" = (
/obj/structure/lattice/catwalk,
/obj/structure/railing/corner/end,
/turf/template_noop,
/area/shuttle/pirate)
"es" = (
/obj/machinery/atmospherics/pipe/smart/manifold4w/supply/hidden{
	dir = 4
	},
/turf/open/floor/plating/airless,
/area/shuttle/pirate)
"ez" = (
/obj/effect/decal/cleanable/dirt,
/obj/machinery/atmospherics/components/unary/vent_pump/on,
/obj/effect/decal/cleanable/blood,
/turf/open/floor/plating/airless,
/area/shuttle/pirate)
"eD" = (
/obj/machinery/button/door{
	id = "piratebridge";
	name = "Bridge Shutters Control";
	pixel_y = -3
	},
/obj/structure/table,
/obj/item/radio/intercom{
	freerange = 1;
	pixel_y = 9
	},
/turf/open/floor/plating/airless,
/area/shuttle/pirate)
"fn" = (
/obj/machinery/atmospherics/pipe/smart/manifold4w/supply/hidden{
	dir = 4
	},
/obj/effect/decal/cleanable/dirt,
/obj/structure/cable,
/turf/open/floor/pod/light,
/area/shuttle/pirate)
"gF" = (
/obj/structure/sink/directional/south,
/obj/structure/mirror/broken/directional/north{
	pixel_y = 34
	},
/turf/open/floor/iron/showroomfloor,
/area/shuttle/pirate)
"gI" = (
/obj/item/chair,
/obj/effect/turf_decal/tile/bar/opposingcorners,
/obj/effect/decal/cleanable/dirt,
/turf/open/floor/iron,
/area/shuttle/pirate)
"hz" = (
/obj/structure/lattice/catwalk,
/obj/structure/railing/corner,
/turf/template_noop,
/area/shuttle/pirate)
"hO" = (
/obj/effect/decal/cleanable/dirt,
/obj/effect/decal/cleanable/dirt,
/obj/machinery/atmospherics/components/unary/vent_pump/on{
	dir = 4
	},
/obj/effect/turf_decal/tile/bar/opposingcorners,
/turf/open/floor/iron,
/area/shuttle/pirate)
"hT" = (
/obj/effect/decal/cleanable/dirt,
/obj/structure/tank_dispenser/oxygen,
/obj/effect/turf_decal/stripes/line{
	dir = 1
	},
/obj/effect/turf_decal/stripes/line{
	dir = 1
	},
/turf/open/floor/iron/smooth,
/area/shuttle/pirate)
"iA" = (
/obj/structure/table,
/obj/effect/decal/cleanable/dirt,
/obj/item/storage/medkit/fire{
	pixel_y = 5
	},
/obj/item/storage/medkit/brute,
/turf/open/floor/pod/light,
/area/shuttle/pirate)
"iG" = (
/obj/machinery/shuttle_scrambler,
/obj/machinery/light/directional/west,
/turf/open/floor/pod/dark,
/area/shuttle/pirate)
"iM" = (
/obj/effect/decal/cleanable/dirt,
/obj/machinery/atmospherics/components/unary/vent_pump/on{
	dir = 4
	},
/obj/structure/sign/flag/mothic/directional/west,
/obj/machinery/light/directional/west,
/turf/open/floor/pod/light,
/area/shuttle/pirate)
"jz" = (
/turf/open/floor/wood,
/area/shuttle/pirate)
"jI" = (
/obj/effect/turf_decal/bot/left,
/obj/effect/turf_decal/stripes/line{
	dir = 8
	},
/turf/open/floor/wood,
/area/shuttle/pirate)
"kb" = (
/obj/machinery/door/airlock/hatch{
	name = "Armory Access"
	},
/obj/machinery/atmospherics/pipe/smart/manifold4w/supply/hidden{
	dir = 4
	},
/obj/effect/mapping_helpers/airlock/cutaiwire,
/turf/open/floor/plating/airless,
/area/shuttle/pirate)
"kv" = (
/obj/structure/lattice/catwalk,
/obj/structure/railing{
	dir = 5
	},
/turf/template_noop,
/area/shuttle/pirate)
"kD" = (
/obj/effect/decal/cleanable/dirt,
/obj/machinery/atmospherics/components/unary/vent_pump/on,
/obj/structure/cable,
/obj/machinery/airalarm/directional/north,
/obj/effect/mapping_helpers/airalarm/all_access,
/obj/machinery/light/directional/north,
/turf/open/floor/pod/light,
/area/shuttle/pirate)
"kI" = (
/obj/machinery/atmospherics/pipe/smart/manifold4w/supply/hidden{
	dir = 4
	},
/obj/structure/chair{
	dir = 8
	},
/obj/effect/turf_decal/tile/bar/opposingcorners,
/obj/machinery/airalarm/directional/east,
/obj/effect/mapping_helpers/airalarm/all_access,
/turf/open/floor/iron,
/area/shuttle/pirate)
"kO" = (
/obj/effect/decal/cleanable/dirt,
/obj/effect/decal/cleanable/wrapping,
/turf/open/floor/pod/dark,
/area/shuttle/pirate)
"lf" = (
/obj/structure/lattice/catwalk,
/obj/structure/railing{
	dir = 10
	},
/turf/template_noop,
/area/shuttle/pirate)
"lv" = (
/obj/structure/lattice/catwalk,
/obj/structure/railing{
	dir = 1
	},
/turf/template_noop,
/area/shuttle/pirate)
"lK" = (
/obj/machinery/piratepad,
/obj/effect/decal/cleanable/dirt,
/turf/open/floor/pod/light,
/area/shuttle/pirate)
"lL" = (
/obj/machinery/atmospherics/pipe/smart/manifold4w/supply/hidden{
	dir = 4
	},
/obj/effect/decal/cleanable/dirt,
/turf/open/floor/wood,
/area/shuttle/pirate)
"lO" = (
/obj/machinery/atmospherics/pipe/smart/manifold4w/supply/hidden{
	dir = 4
	},
/turf/open/floor/wood,
/area/shuttle/pirate)
"lU" = (
/obj/machinery/atmospherics/pipe/smart/manifold4w/supply/hidden{
	dir = 4
	},
/obj/effect/decal/cleanable/dirt,
/turf/open/floor/iron/smooth,
/area/shuttle/pirate)
"mp" = (
/obj/machinery/atmospherics/pipe/smart/manifold4w/supply/hidden{
	dir = 4
	},
/obj/effect/decal/cleanable/dirt,
/obj/structure/cable,
/turf/open/floor/plating/airless,
/area/shuttle/pirate)
"mT" = (
/obj/effect/decal/cleanable/dirt,
/obj/machinery/atmospherics/components/unary/vent_pump/on{
	dir = 8
	},
/turf/open/floor/pod/light,
/area/shuttle/pirate)
"nn" = (
/obj/structure/lattice/catwalk,
/obj/structure/railing/corner/end{
	dir = 4
	},
/turf/template_noop,
/area/shuttle/pirate)
"oa" = (
/obj/effect/spawner/structure/window/survival_pod,
/turf/open/floor/plating/airless,
/area/shuttle/pirate)
"oh" = (
/obj/effect/decal/cleanable/dirt,
/obj/machinery/computer/shuttle/pirate,
/turf/open/floor/plating/airless,
/area/shuttle/pirate)
"oj" = (
/obj/effect/decal/cleanable/dirt,
/turf/open/floor/plating/airless,
/area/shuttle/pirate)
"om" = (
/obj/structure/toilet{
	dir = 4
	},
/turf/open/floor/plating/airless,
/area/shuttle/pirate)
"oq" = (
/obj/structure/table,
/obj/effect/decal/cleanable/dirt,
/obj/item/gun/ballistic/rifle/boltaction,
/obj/item/ammo_box/strilka310{
	pixel_x = 7;
	pixel_y = 8
	},
/obj/item/ammo_box/strilka310{
	pixel_y = 8;
	pixel_x = -8
	},
/turf/open/floor/pod/light,
/area/shuttle/pirate)
"ot" = (
/obj/machinery/airalarm/directional/west,
/obj/effect/mapping_helpers/airalarm/all_access,
/obj/structure/table,
/obj/machinery/light/directional/west,
/turf/open/floor/pod/light,
/area/shuttle/pirate)
"oz" = (
/obj/machinery/suit_storage_unit/pirate{
	helmet_type = /obj/item/clothing/head/helmet/space/pirate/tophat;
	suit_type = /obj/item/clothing/suit/space/pirate/silverscale
	},
/obj/effect/turf_decal/bot_red,
/obj/effect/turf_decal/stripes/line{
	dir = 1
	},
/turf/open/floor/iron/smooth,
/area/shuttle/pirate)
"oF" = (
/obj/structure/table/wood,
/obj/item/food/pizza/mothic_pesto,
/turf/open/floor/plating/airless,
/area/shuttle/pirate)
"oW" = (
/obj/machinery/power/shuttle_engine/heater,
/obj/structure/window/reinforced/spawner/directional/north{
	pixel_y = 1
	},
/turf/open/floor/plating/airless,
/area/shuttle/pirate)
"pz" = (
/obj/effect/decal/cleanable/dirt,
/obj/machinery/atmospherics/pipe/smart/manifold4w/supply/hidden{
	dir = 4
	},
/turf/open/floor/plating/airless,
/area/shuttle/pirate)
"pI" = (
/obj/machinery/loot_locator,
/turf/open/floor/plating/airless,
/area/shuttle/pirate)
"qn" = (
/obj/effect/decal/cleanable/dirt,
/obj/structure/table,
/obj/machinery/recharger,
/turf/open/floor/pod/light,
/area/shuttle/pirate)
"qA" = (
/obj/effect/decal/cleanable/dirt,
/obj/machinery/light/directional/west,
/turf/open/floor/pod/light,
/area/shuttle/pirate)
"qF" = (
/obj/effect/decal/cleanable/dirt,
/obj/effect/decal/cleanable/garbage,
/turf/open/floor/pod/light,
/area/shuttle/pirate)
"qR" = (
/obj/structure/table,
/obj/effect/decal/cleanable/dirt,
/obj/item/gun/energy/laser{
	pixel_x = -2;
	pixel_y = 5
	},
/obj/item/gun/energy/laser,
/turf/open/floor/pod/light,
/area/shuttle/pirate)
"qZ" = (
/turf/closed/wall/mineral/titanium/survival/nodiagonal,
/area/shuttle/pirate)
"rh" = (
/obj/structure/table,
/obj/item/storage/toolbox/syndicate,
/turf/open/floor/pod/light,
/area/shuttle/pirate)
"ro" = (
/obj/structure/lattice/catwalk,
/obj/structure/railing/corner{
	dir = 1
	},
/turf/template_noop,
/area/shuttle/pirate)
"rq" = (
/obj/machinery/power/smes/ship,
/obj/effect/decal/cleanable/dirt,
/obj/structure/cable,
/turf/open/floor/plating/airless,
/area/shuttle/pirate)
"so" = (
/obj/machinery/porta_turret/syndicate/energy{
	dir = 8;
	faction = list("pirate")
	},
/turf/closed/wall/mineral/titanium/survival/nodiagonal,
/area/shuttle/pirate)
"sy" = (
/obj/machinery/atmospherics/pipe/smart/manifold4w/supply/hidden{
	dir = 4
	},
/obj/machinery/door/airlock/hatch{
	name = "Armory Access"
	},
/obj/effect/mapping_helpers/airlock/cutaiwire,
/turf/open/floor/plating/airless,
/area/shuttle/pirate)
"sO" = (
/obj/structure/lattice/catwalk,
/obj/structure/railing/corner{
	dir = 8
	},
/turf/template_noop,
/area/shuttle/pirate)
"tf" = (
/obj/structure/table,
/obj/item/storage/fancy/cigarettes/cigars/havana{
	pixel_y = 9
	},
/obj/item/lighter,
/turf/open/floor/plating/airless,
/area/shuttle/pirate)
"ue" = (
/obj/effect/decal/cleanable/dirt,
/obj/effect/decal/cleanable/dirt,
/turf/open/floor/wood,
/area/shuttle/pirate)
"uk" = (
/obj/machinery/suit_storage_unit/pirate{
	helmet_type = /obj/item/clothing/head/helmet/space/pirate/tophat;
	suit_type = /obj/item/clothing/suit/space/pirate/silverscale
	},
/obj/effect/turf_decal/bot_red,
/obj/machinery/light/directional/west,
/turf/open/floor/iron/smooth,
/area/shuttle/pirate)
"uq" = (
/obj/machinery/atmospherics/components/tank/air,
/turf/open/floor/pod/light,
/area/shuttle/pirate)
"vS" = (
/turf/template_noop,
/area/template_noop)
"wa" = (
/obj/effect/decal/cleanable/dirt,
/turf/closed/wall/mineral/titanium/survival/nodiagonal,
/area/shuttle/pirate)
"we" = (
/obj/effect/decal/cleanable/dirt,
/obj/machinery/atmospherics/pipe/smart/manifold4w/supply/hidden{
	dir = 4
	},
/obj/effect/decal/cleanable/insectguts,
/turf/open/floor/iron/showroomfloor,
/area/shuttle/pirate)
"wv" = (
/obj/effect/decal/cleanable/dirt,
/obj/machinery/button/door/directional/east{
	name = "External Bolt Control";
	id = "piratestarboardexternal"
	},
/turf/open/floor/iron/smooth,
/area/shuttle/pirate)
"wQ" = (
/obj/effect/decal/cleanable/dirt,
/obj/effect/decal/cleanable/garbage,
/turf/open/floor/plating/airless,
/area/shuttle/pirate)
"xt" = (
/obj/machinery/door/airlock/command,
/obj/machinery/atmospherics/pipe/smart/manifold4w/supply/hidden{
	dir = 4
	},
/obj/effect/mapping_helpers/airlock/cutaiwire,
/turf/open/floor/plating/airless,
/area/shuttle/pirate)
"xL" = (
/obj/machinery/atmospherics/pipe/smart/manifold4w/supply/hidden{
	dir = 4
	},
/obj/effect/decal/cleanable/dirt,
/turf/open/floor/plating/airless,
/area/shuttle/pirate)
"xS" = (
/obj/effect/decal/cleanable/dirt,
/turf/open/floor/pod/light,
/area/shuttle/pirate)
"zC" = (
/obj/machinery/suit_storage_unit/pirate{
	helmet_type = /obj/item/clothing/head/helmet/space/pirate/tophat;
	suit_type = /obj/item/clothing/suit/space/pirate/silverscale
	},
/obj/effect/turf_decal/bot_red,
/turf/open/floor/plating/airless,
/area/shuttle/pirate)
"AV" = (
/obj/structure/cable,
/obj/effect/decal/cleanable/wrapping,
/turf/open/floor/pod/light,
/area/shuttle/pirate)
"Bb" = (
/obj/effect/decal/cleanable/dirt,
/obj/effect/decal/cleanable/ants,
/turf/open/floor/pod/light,
/area/shuttle/pirate)
"Bc" = (
/obj/machinery/suit_storage_unit/pirate{
	helmet_type = /obj/item/clothing/head/helmet/space/pirate/tophat;
	suit_type = /obj/item/clothing/suit/space/pirate/silverscale
	},
/obj/effect/turf_decal/bot_red,
/obj/machinery/light/directional/east,
/turf/open/floor/iron/smooth,
/area/shuttle/pirate)
"Bm" = (
/obj/structure/railing{
	dir = 6
	},
/obj/structure/lattice/catwalk,
/turf/template_noop,
/area/shuttle/pirate)
"BE" = (
/obj/effect/turf_decal/tile/bar/opposingcorners,
/obj/effect/decal/cleanable/dirt,
/obj/effect/decal/cleanable/garbage,
/turf/open/floor/iron,
/area/shuttle/pirate)
"BV" = (
/obj/structure/lattice/catwalk,
/obj/structure/railing{
	dir = 8
	},
/turf/template_noop,
/area/shuttle/pirate)
"CZ" = (
/obj/item/spear/military{
	pixel_y = 4
	},
/obj/structure/rack,
/obj/item/claymore/shortsword{
	pixel_y = -5
	},
/turf/open/floor/pod/light,
/area/shuttle/pirate)
"Dn" = (
/obj/machinery/light/directional/west,
/turf/open/floor/pod/light,
/area/shuttle/pirate)
"Dt" = (
/obj/machinery/door/airlock{
	name = "Crew Cabin"
	},
/obj/machinery/atmospherics/pipe/smart/manifold4w/supply/hidden{
	dir = 4
	},
/obj/effect/mapping_helpers/airlock/cutaiwire,
/turf/open/floor/plating/airless,
/area/shuttle/pirate)
"DU" = (
/obj/machinery/door/airlock/external/glass/ruin{
	id_tag = "pirateportexternal"
	},
/obj/effect/mapping_helpers/airlock/locked,
/obj/effect/mapping_helpers/airlock/cutaiwire,
/obj/effect/mapping_helpers/airlock/cyclelink_helper{
	dir = 4
	},
/obj/docking_port/mobile/pirate{
	dir = 8
	},
/turf/open/floor/plating/airless,
/area/shuttle/pirate)
"ET" = (
/obj/effect/decal/cleanable/dirt,
/obj/effect/decal/cleanable/blood,
/turf/open/floor/wood,
/area/shuttle/pirate)
"Fo" = (
/obj/machinery/power/port_gen/pacman{
	anchored = 1
	},
/obj/machinery/atmospherics/pipe/smart/manifold4w/supply/hidden{
	dir = 4
	},
/turf/open/floor/plating/airless,
/area/shuttle/pirate)
"FB" = (
/obj/machinery/atmospherics/pipe/smart/manifold4w/supply/hidden{
	dir = 4
	},
/obj/machinery/space_heater,
/turf/open/floor/pod/light,
/area/shuttle/pirate)
"FJ" = (
/obj/item/kirbyplants/random,
/turf/open/floor/plating/airless,
/area/shuttle/pirate)
"FL" = (
/obj/machinery/power/shuttle_engine/propulsion/left,
/turf/open/floor/plating/airless,
/area/shuttle/pirate)
"Ge" = (
/obj/machinery/computer/piratepad_control{
	dir = 8
	},
/turf/open/floor/plating/airless,
/area/shuttle/pirate)
"Gg" = (
/obj/machinery/atmospherics/components/unary/vent_pump/on{
	dir = 8
	},
/obj/structure/cable,
/turf/open/floor/pod/light,
/area/shuttle/pirate)
"Gl" = (
/obj/machinery/door/airlock/external/glass/ruin{
	id_tag = "pirateportexternal"
	},
/obj/effect/decal/cleanable/dirt,
/obj/effect/mapping_helpers/airlock/locked,
/obj/effect/mapping_helpers/airlock/cutaiwire,
/obj/effect/mapping_helpers/airlock/cyclelink_helper{
	dir = 8
	},
/turf/open/floor/plating/airless,
/area/shuttle/pirate)
"Gw" = (
/obj/structure/lattice/catwalk,
/obj/structure/railing/corner{
	dir = 4
	},
/obj/structure/railing/corner{
	dir = 4
	},
/turf/template_noop,
/area/shuttle/pirate)
"Ht" = (
/turf/open/floor/plating/airless,
/area/shuttle/pirate)
"HT" = (
/obj/effect/decal/cleanable/dirt,
/obj/machinery/vending/boozeomat,
/turf/open/floor/plating/airless,
/area/shuttle/pirate)
"If" = (
/obj/machinery/door/airlock/highsecurity,
/obj/machinery/atmospherics/pipe/smart/manifold4w/supply/hidden{
	dir = 4
	},
/obj/effect/mapping_helpers/airlock/cutaiwire,
/turf/open/floor/plating/airless,
/area/shuttle/pirate)
"Ii" = (
/obj/effect/decal/cleanable/dirt,
/obj/machinery/atmospherics/components/unary/vent_pump/on{
	dir = 8
	},
/turf/open/floor/pod/dark,
/area/shuttle/pirate)
"IN" = (
/obj/effect/decal/cleanable/wrapping,
/turf/open/floor/pod/light,
/area/shuttle/pirate)
"Je" = (
/obj/effect/decal/cleanable/dirt,
/obj/structure/chair/office{
	dir = 8
	},
/turf/open/floor/plating/airless,
/area/shuttle/pirate)
"JJ" = (
/obj/effect/decal/cleanable/dirt,
/obj/item/shovel,
/turf/open/floor/plating/airless,
/area/shuttle/pirate)
"JS" = (
/obj/effect/spawner/random/structure/tank_holder,
/turf/open/floor/pod/light,
/area/shuttle/pirate)
"Kd" = (
/obj/structure/table/wood,
/obj/effect/decal/cleanable/dirt,
/obj/item/food/cake/mothmallow,
/turf/open/floor/plating/airless,
/area/shuttle/pirate)
"Kz" = (
/obj/structure/lattice/catwalk,
/turf/template_noop,
/area/shuttle/pirate)
"KX" = (
/obj/effect/decal/cleanable/dirt,
/obj/item/stack/rods{
	amount = 3
	},
/turf/open/floor/pod/light,
/area/shuttle/pirate)
"La" = (
/obj/structure/table/wood,
/obj/machinery/microwave{
	pixel_y = 5
	},
/turf/open/floor/plating/airless,
/area/shuttle/pirate)
"LS" = (
/obj/effect/decal/cleanable/dirt,
/turf/open/floor/wood,
/area/shuttle/pirate)
"Mc" = (
/obj/effect/decal/cleanable/dirt,
/obj/effect/turf_decal/bot/left,
/obj/effect/turf_decal/stripes/line{
	dir = 9
	},
/turf/open/floor/plating/airless,
/area/shuttle/pirate)
"Me" = (
/obj/effect/decal/cleanable/dirt,
/obj/structure/table/wood,
/turf/open/floor/wood,
/area/shuttle/pirate)
"Mt" = (
/obj/structure/table,
/obj/item/reagent_containers/cup/glass/bottle/wine{
	pixel_y = 6
	},
/obj/item/reagent_containers/cup/glass/drinkingglass{
	pixel_x = 9;
	pixel_y = 9
	},
/obj/machinery/light/directional/east,
/turf/open/floor/plating/airless,
/area/shuttle/pirate)
"MG" = (
/obj/effect/decal/cleanable/dirt,
/obj/structure/table/reinforced,
/obj/machinery/recharger,
/turf/open/floor/plating/airless,
/area/shuttle/pirate)
"Nn" = (
/obj/machinery/atmospherics/pipe/smart/manifold4w/supply/hidden{
	dir = 4
	},
/obj/effect/turf_decal/tile/bar/opposingcorners,
/obj/effect/decal/cleanable/dirt,
/turf/open/floor/iron,
/area/shuttle/pirate)
"Nx" = (
/obj/effect/mapping_helpers/airlock/locked,
/obj/effect/mapping_helpers/airlock/cutaiwire,
/obj/effect/mapping_helpers/airlock/cyclelink_helper{
	dir = 8
	},
/obj/machinery/door/airlock/external/glass/ruin{
	id_tag = "piratestarboardexternal"
	},
/turf/open/floor/plating/airless,
/area/shuttle/pirate)
"NY" = (
/obj/structure/table/wood,
/obj/machinery/recharger,
/turf/open/floor/wood,
/area/shuttle/pirate)
"Om" = (
/obj/structure/cable,
/turf/open/floor/pod/light,
/area/shuttle/pirate)
"Ou" = (
/obj/effect/decal/cleanable/dirt,
/obj/machinery/atmospherics/components/unary/vent_pump/on,
/turf/open/floor/iron/showroomfloor,
/area/shuttle/pirate)
"Ox" = (
/obj/structure/lattice/catwalk,
/obj/structure/railing/corner{
	dir = 4
	},
/turf/template_noop,
/area/shuttle/pirate)
"Pd" = (
/obj/machinery/power/terminal{
	dir = 4
	},
/obj/structure/rack,
/obj/item/storage/toolbox/mechanical{
	pixel_y = 4
	},
/obj/item/flashlight{
	pixel_x = 3;
	pixel_y = 3
	},
/obj/item/storage/box/lights/bulbs,
/obj/item/stack/sheet/mineral/plasma{
	amount = 10
	},
/obj/item/multitool,
/obj/structure/cable,
/obj/machinery/atmospherics/pipe/smart/manifold4w/supply/hidden{
	dir = 4
	},
/turf/open/floor/pod/light,
/area/shuttle/pirate)
"Pe" = (
/obj/structure/closet/crate,
/turf/open/floor/plating/airless,
/area/shuttle/pirate)
"Pp" = (
/obj/effect/decal/cleanable/dirt,
/obj/item/kirbyplants/random,
/turf/open/floor/plating/airless,
/area/shuttle/pirate)
"PP" = (
/obj/effect/decal/cleanable/wrapping,
/obj/machinery/light/directional/east,
/turf/open/floor/wood,
/area/shuttle/pirate)
"PT" = (
/obj/structure/chair{
	dir = 4
	},
/obj/effect/turf_decal/tile/bar/opposingcorners,
/obj/effect/decal/cleanable/dirt,
/obj/effect/decal/cleanable/vomit,
/turf/open/floor/iron,
/area/shuttle/pirate)
"PV" = (
/turf/open/floor/pod/light,
/area/shuttle/pirate)
"Qk" = (
/obj/structure/lattice/catwalk,
/obj/structure/railing{
	dir = 1
	},
/obj/structure/railing/corner/end{
	dir = 1
	},
/turf/template_noop,
/area/shuttle/pirate)
"Qm" = (
/obj/effect/turf_decal/bot/left,
/obj/machinery/light/directional/west,
/obj/effect/turf_decal/stripes/line{
	dir = 8
	},
/turf/open/floor/plating/airless,
/area/shuttle/pirate)
"Qu" = (
/obj/structure/lattice/catwalk,
/obj/structure/railing{
	dir = 1
	},
/obj/structure/railing/corner/end{
	dir = 8
	},
/turf/template_noop,
/area/shuttle/pirate)
"QC" = (
/obj/machinery/atmospherics/pipe/smart/manifold4w/supply/hidden{
	dir = 4
	},
/obj/effect/decal/cleanable/dirt,
/turf/open/floor/pod/light,
/area/shuttle/pirate)
"QQ" = (
/obj/effect/turf_decal/tile/bar/opposingcorners,
/obj/effect/decal/cleanable/dirt,
/obj/effect/turf_decal/bot/left,
/obj/machinery/light/directional/south,
/obj/effect/turf_decal/stripes/line{
	dir = 6
	},
/turf/open/floor/iron,
/area/shuttle/pirate)
"QX" = (
/obj/machinery/airalarm/directional/north,
/obj/effect/mapping_helpers/airalarm/all_access,
/turf/open/floor/iron/smooth,
/area/shuttle/pirate)
"Rb" = (
/obj/machinery/atmospherics/pipe/smart/manifold4w/supply/hidden{
	dir = 4
	},
/obj/effect/decal/cleanable/dirt,
/turf/open/floor/pod/dark,
/area/shuttle/pirate)
"Rk" = (
/obj/machinery/power/apc/auto_name/directional/north,
/obj/effect/decal/cleanable/dirt,
/obj/structure/cable,
/obj/effect/decal/cleanable/chem_pile,
/obj/effect/mapping_helpers/apc/cut_AI_wire,
/turf/open/floor/plating/airless,
/area/shuttle/pirate)
"Rz" = (
/obj/structure/lattice/catwalk,
/obj/structure/railing{
	dir = 8
	},
/obj/structure/sign/flag/mothic/directional/east,
/turf/template_noop,
/area/shuttle/pirate)
"RM" = (
/obj/machinery/atmospherics/pipe/smart/manifold4w/supply/hidden{
	dir = 4
	},
/turf/open/floor/pod/light,
/area/shuttle/pirate)
"RV" = (
/obj/effect/decal/cleanable/dirt,
/obj/machinery/airalarm/directional/south,
/obj/effect/mapping_helpers/airalarm/all_access,
/turf/open/floor/pod/dark,
/area/shuttle/pirate)
"Sg" = (
/obj/machinery/atmospherics/pipe/smart/manifold4w/supply/hidden{
	dir = 4
	},
/obj/effect/turf_decal/tile/bar/opposingcorners,
/turf/open/floor/iron,
/area/shuttle/pirate)
"Sl" = (
/obj/structure/chair/office{
	dir = 1
	},
/turf/open/floor/pod/dark,
/area/shuttle/pirate)
"St" = (
/obj/machinery/suit_storage_unit/pirate{
	helmet_type = /obj/item/clothing/head/helmet/space/pirate/tophat;
	suit_type = /obj/item/clothing/suit/space/pirate/silverscale
	},
/obj/effect/turf_decal/bot_red,
/obj/effect/turf_decal/stripes/line{
	dir = 1
	},
/turf/open/floor/plating/airless,
/area/shuttle/pirate)
"Sw" = (
/obj/effect/decal/cleanable/dirt,
/obj/item/stack/cable_coil/thirty,
/turf/open/floor/pod/light,
/area/shuttle/pirate)
"SD" = (
/turf/open/floor/pod/dark,
/area/shuttle/pirate)
"SM" = (
/obj/structure/chair{
	dir = 4
	},
/turf/open/floor/plating/airless,
/area/shuttle/pirate)
"SO" = (
/obj/effect/decal/cleanable/dirt,
/obj/structure/cable,
/obj/machinery/power/terminal,
/turf/open/floor/plating/airless,
/area/shuttle/pirate)
"Tf" = (
/obj/machinery/airalarm/directional/south,
/obj/effect/mapping_helpers/airalarm/all_access,
/turf/open/floor/pod/light,
/area/shuttle/pirate)
"TK" = (
/obj/effect/decal/cleanable/dirt,
/turf/open/floor/pod/dark,
/area/shuttle/pirate)
"Uf" = (
/obj/effect/mapping_helpers/airlock/locked,
/obj/effect/mapping_helpers/airlock/cutaiwire,
/obj/effect/mapping_helpers/airlock/cyclelink_helper{
	dir = 4
	},
/obj/machinery/door/airlock/external/glass/ruin{
	id_tag = "piratestarboardexternal"
	},
/turf/open/floor/plating/airless,
/area/shuttle/pirate)
"Uk" = (
/obj/effect/decal/cleanable/dirt,
/turf/open/floor/iron/smooth,
/area/shuttle/pirate)
"Uq" = (
/obj/structure/lattice/catwalk,
/obj/structure/railing{
	dir = 4
	},
/obj/structure/sign/flag/mothic/directional/west,
/turf/template_noop,
/area/shuttle/pirate)
"UH" = (
/obj/machinery/atmospherics/pipe/smart/manifold4w/supply/hidden{
	dir = 4
	},
/turf/open/floor/pod/dark,
/area/shuttle/pirate)
"Vc" = (
/obj/effect/decal/cleanable/dirt,
/obj/machinery/button/door/directional/west{
	id = "pirateportexternal";
	name = "External Bolt Control"
	},
/turf/open/floor/iron/smooth,
/area/shuttle/pirate)
"Vv" = (
/obj/machinery/atmospherics/components/unary/vent_pump/on{
	dir = 4
	},
/turf/open/floor/iron/smooth,
/area/shuttle/pirate)
"VA" = (
/obj/structure/chair/office{
	dir = 8
	},
/turf/open/floor/pod/dark,
/area/shuttle/pirate)
"VE" = (
/obj/structure/table/wood,
/obj/effect/turf_decal/tile/bar/opposingcorners,
/obj/item/storage/box/donkpockets/donkpocketberry,
/obj/item/storage/box/donkpockets/donkpocketberry{
	pixel_x = -6
	},
/obj/item/reagent_containers/cup/glass/bottle/rum{
	name = "Captain Pete's Private Reserve Cuban Spaced Rum";
	pixel_x = 8;
	pixel_y = 11
	},
/obj/machinery/light/directional/north,
/turf/open/floor/iron,
/area/shuttle/pirate)
"VK" = (
/obj/effect/spawner/structure/window/survival_pod,
/obj/machinery/door/poddoor/shutters/preopen{
	id = "mothicbridge"
	},
/turf/open/floor/plating/airless,
/area/shuttle/pirate)
"Wd" = (
/obj/effect/spawner/random/entertainment/arcade{
	dir = 8
	},
/turf/open/floor/plating/airless,
/area/shuttle/pirate)
"Wo" = (
/obj/effect/turf_decal/bot/left,
/obj/effect/turf_decal/stripes/line{
	dir = 10
	},
/turf/open/floor/plating/airless,
/area/shuttle/pirate)
"WA" = (
/obj/machinery/atmospherics/pipe/smart/manifold4w/supply/hidden{
	dir = 4
	},
/obj/structure/cable,
/turf/open/floor/plating/airless,
/area/shuttle/pirate)
"WM" = (
/obj/effect/decal/cleanable/chem_pile,
/turf/open/floor/plating/airless,
/area/shuttle/pirate)
"Xe" = (
/obj/machinery/computer/camera_advanced/shuttle_docker/syndicate/pirate,
/turf/open/floor/plating/airless,
/area/shuttle/pirate)
"Xz" = (
/obj/structure/table,
/obj/machinery/cell_charger,
/obj/item/stock_parts/power_store/cell/high,
/turf/open/floor/pod/light,
/area/shuttle/pirate)
"XA" = (
/obj/effect/turf_decal/bot/left,
/obj/machinery/airalarm/directional/west,
/obj/effect/mapping_helpers/airalarm/all_access,
/obj/effect/turf_decal/stripes/line{
	dir = 8
	},
/turf/open/floor/iron/showroomfloor,
/area/shuttle/pirate)
"XL" = (
/obj/structure/table,
/obj/effect/decal/cleanable/dirt,
/obj/item/gun/energy/laser,
/obj/item/gun/energy/laser{
	pixel_x = -2;
	pixel_y = 5
	},
/obj/machinery/light/directional/north,
/turf/open/floor/pod/light,
/area/shuttle/pirate)
"Yh" = (
/turf/open/floor/iron/smooth,
/area/shuttle/pirate)
"Yu" = (
/obj/effect/decal/cleanable/dirt,
/obj/machinery/atmospherics/components/unary/vent_pump/on,
/turf/open/floor/pod/light,
/area/shuttle/pirate)
"YN" = (
/obj/machinery/door/airlock/hatch,
/obj/machinery/atmospherics/pipe/smart/manifold4w/supply/hidden{
	dir = 4
	},
/obj/effect/mapping_helpers/airlock/cutaiwire,
/turf/open/floor/plating/airless,
/area/shuttle/pirate)
"YY" = (
/obj/effect/turf_decal/bot/left,
/obj/effect/turf_decal/stripes/line{
	dir = 1
	},
/turf/open/floor/wood,
/area/shuttle/pirate)
"ZX" = (
/obj/structure/table,
/obj/item/storage/backpack/duffelbag/syndie/x4{
	pixel_y = 8
	},
/obj/item/storage/backpack/duffelbag/syndie/c4,
/obj/item/grenade/smokebomb{
	pixel_x = 6;
	pixel_y = 4
	},
/obj/item/grenade/smokebomb{
	pixel_x = -3;
	pixel_y = 4
	},
/obj/machinery/airalarm/directional/south,
/obj/effect/mapping_helpers/airalarm/all_access,
/turf/open/floor/pod/light,
/area/shuttle/pirate)

(1,1,1) = {"
vS
vS
vS
vS
vS
cO
Rz
BV
BV
BV
lf
vS
vS
vS
vS
vS
cO
Kz
Kz
Kz
Kz
lf
vS
vS
vS
vS
vS
vS
vS
vS
vS
"}
(2,1,1) = {"
vS
vS
vS
vS
cO
ro
qZ
qZ
qZ
qZ
sO
lf
vS
vS
vS
cO
ro
qZ
qZ
qZ
qZ
sO
lf
vS
vS
vS
vS
vS
vS
vS
vS
"}
(3,1,1) = {"
vS
vS
vS
vS
lv
qZ
qZ
jI
Qm
wa
so
cS
vS
cO
Rz
ro
qZ
qZ
SO
rq
qZ
so
cS
vS
vS
vS
vS
vS
vS
vS
vS
"}
(4,1,1) = {"
vS
vS
vS
vS
Qk
qZ
YY
LS
ue
Ht
qZ
sO
BV
ro
qZ
qZ
qZ
qZ
AV
Pd
oW
FL
cS
vS
vS
vS
vS
vS
vS
vS
vS
"}
(5,1,1) = {"
vS
vS
vS
vS
so
qZ
YY
ez
lL
dp
qZ
qZ
Kz
Kz
qZ
om
XA
qZ
kD
Fo
oW
FL
sO
lf
vS
vS
vS
vS
vS
vS
vS
"}
(6,1,1) = {"
vS
vS
VK
qZ
qZ
qZ
Me
jz
lL
Ht
jz
qZ
qZ
qZ
qZ
Ou
we
qZ
fn
FB
qZ
qZ
qZ
dq
Kz
Kz
qZ
DU
qZ
vS
vS
"}
(7,1,1) = {"
vS
VK
VK
iG
pI
qZ
NY
PP
lO
ET
FJ
qZ
qZ
qZ
wa
gF
pz
qZ
fn
uq
qZ
Pp
qZ
qZ
ao
qZ
qZ
oj
qZ
vS
vS
"}
(8,1,1) = {"
VK
VK
Mc
kO
RV
qZ
qZ
qZ
Dt
qZ
qZ
qZ
qZ
qZ
ao
qZ
kb
qZ
aA
qZ
qZ
qF
qZ
aW
uk
zC
qZ
Gl
qZ
qZ
so
"}
(9,1,1) = {"
VK
Xe
Sl
TK
Ht
oa
Ht
Dn
RM
Pe
iM
KX
Tf
qZ
qn
ot
es
WM
WA
Dn
JJ
PV
qZ
Ht
Uk
oj
Vc
Vv
oz
oW
FL
"}
(10,1,1) = {"
VK
MG
TK
UH
Rb
xt
es
QC
QC
QC
RM
QC
QC
YN
es
QC
QC
QC
fn
RM
es
QC
kb
Ht
es
lU
xL
lU
hT
oW
FL
"}
(11,1,1) = {"
VK
oh
VA
Ii
SD
oa
xS
IN
es
xS
lK
Ge
wQ
qZ
Rk
Om
Gg
Om
mp
oj
mT
Sw
qZ
QX
Yh
Ht
wv
Yh
St
oW
FL
"}
(12,1,1) = {"
VK
VK
eD
SD
Je
qZ
qZ
qZ
If
qZ
qZ
qZ
qZ
qZ
qZ
qZ
oa
oa
sy
oa
wa
KX
qZ
aW
Bc
zC
qZ
Uf
qZ
qZ
so
"}
(13,1,1) = {"
vS
VK
VK
Mt
tf
qZ
qR
PV
RM
qA
rh
qZ
qZ
qZ
qZ
HT
BE
Ht
Sg
Wo
qZ
JS
qZ
qZ
ao
qZ
qZ
oj
qZ
vS
vS
"}
(14,1,1) = {"
vS
vS
VK
qZ
qZ
qZ
oq
Bb
QC
PV
iA
qZ
qZ
qZ
qZ
VE
gI
hO
Sg
QQ
qZ
qZ
qZ
nn
Kz
Kz
qZ
Nx
qZ
vS
vS
"}
(15,1,1) = {"
vS
vS
vS
vS
so
qZ
XL
Yu
QC
ZX
qZ
qZ
Kz
Kz
qZ
La
kI
Nn
Nn
oj
oW
FL
hz
cU
vS
vS
vS
vS
vS
vS
vS
"}
(16,1,1) = {"
vS
vS
vS
vS
Qu
qZ
oq
xS
xS
Xz
qZ
hz
cB
Ox
qZ
qZ
qZ
Wd
PT
SM
oW
FL
cS
vS
vS
vS
vS
vS
vS
vS
vS
"}
(17,1,1) = {"
vS
vS
vS
vS
lv
qZ
qZ
CZ
dh
qZ
so
cS
vS
kv
Uq
Ox
qZ
qZ
oF
Kd
qZ
so
cS
vS
vS
vS
vS
vS
vS
vS
vS
"}
(18,1,1) = {"
vS
vS
vS
vS
kv
Gw
qZ
qZ
qZ
qZ
hz
Bm
vS
vS
vS
kv
Ox
qZ
qZ
qZ
qZ
hz
cU
vS
vS
vS
vS
vS
vS
vS
vS
"}
(19,1,1) = {"
vS
vS
vS
vS
vS
kv
Uq
cB
cB
cB
cU
vS
vS
vS
vS
vS
kv
Kz
Kz
Kz
Kz
cU
vS
vS
vS
vS
vS
vS
vS
vS
vS
"}
